3
      X
      X
      X
      X
      *
      *
      *
      *
      *
      *
      *
      *
      *
      W
      W
      W
      W
      W
* *** W
* *** W
* *** W
* *** W
* *** W
* *** W
* *** W
* *** W
* *** W
*
*
*
******W
******W
******W
******W
*
*
*
*
*


*
*     *
*     *
* WWW *
* WWW *
* WWW *
* WWW *
* WWW *
* WWW *


* WWW *
* WWW *
* WWW *
* WWW *
* WWW *
* WWW *
*     *
*     *
*     *
*     *
*     *
*     *
W     W
W     W
WFFFFFW
WFFFFFW
WFFFFFW
WFFFFFW
W     W
W     W
WFFFFFW
WFFFFFW
WFFFFFW
WFFFFFW
W     W
W     W
WWWFWWW
WWWFWWW
WWWFWWW
WWWFWWW


WWW WWW
WWW WWW
WWW WWW
WWW WWW
WWWFWWW
WWWFWWW
WWWFWWW
WWWFWWW
WWW WWW
WWW WWW
WWWFWWW
WWWFWWW
WWWFWWW
WWWFWWW
WWW WWW
WWW WWW
   *
   *
   *
   *
WWW*WWW
WWW*WWW
WWW*WWW
WWW*WWW
   *
   *
   *
   *
WWW*WWW
WWW*WWW
WWW*WWW
WWW*WWW


   *
   *
   T
   T
   T
   *
   *
   *
   *
   *