1
XXXXXXX
XXXXXXX
XXXXXXX
XXXXXXX
*******
*******
*******
*******
WWWWWWW
WWWWWWW
WWWWWWW
WWWWWWW
**WWW**
**WWW**
**WWW**
**WWW**
**WWW**
**WWW**
**WWW**
**WWW**
  ***
  ***
  ***
  ***
  ***
  ***
  WWW W
  WWW W
  *** W
  *** W
  *** W
  *** W
  *** W
  *** W
W *** W
W *** W
W *** W
W *** W
W *** W
W *** W
W *** W


 *   *
 *   *
 *   *
 *   *
*******
*******
*     *
*     *
*   F *
*   F *
*   F *
*   F *
*   F *
*     *
*     *
**    *
*******
T*****T
T*****T
T*****T
T*****T
T*****T
T*****T
T*****T
T*****T
*   * *
*   * *
*   * *
*   * *
*   * *
*   * *
*   * *
*   * *
W   W W
W   W W
W   W W
W   W W
*   * *
*   * *
*   * *
*   * *
*   * *
*   * *
*   * *
*   * *


*   * *
*   * *
*   * *
*   * *
*   * *
*   * *
*   * *
*   * *
W   * W
W   * W
W   * W
W   * W
*   * *
*   * *
*   * *
*   * *
*   * *
*   * *
*   * *
*   * *
*   * *
*******
*******
*******
*******
*******
*******
*******
*******
 *****
  ***
  ***
*  *  *
*  *  *
**   **
**   **
 *****
 *****
  ***
  ***
  ***
  ***
  ***
  ***
  ***
  ***

  ***
 *****
 *****
 *****
 *   *

  ***
 *****
 *****
 *****
 *****
 *   *
 *   *
 * * *
 * * *
   *
   *
   *
   *
   *
** * **
** * **
** * **
** * **
   *
   *
FF * FF
FF * FF
FF * FF
FF * FF
   *
   *
** * **
** * **
** * **
** * **
   T
   T
   T
   T
   T
   T
W*****
W*****
W*****
W*****
W*****
W*****
  ****
  ****
  ****


  ****
  ****
  ****
  ****
  ****
  ****
  ****
WWWW*WW
WWWW*WW
WWWW*WW
WWWW*WW
  ***
  ***
  ***
  ***
  ****W
  ****W
  ****W
  ****W
  ****W
  ****W
  ****W
  ****W


W***
W***
W***
W***
W***
W***
W***
W***
W***
  *
  *
  *
  *
  *
  *
  *
  *
*****WW
*****WW
*****WW
*****WW
*****WW
*****WW
*****WW
*****WW