   X
   X
   X
   X
   *
   *
   *
   *
   *
   *
   *
   *
   *
   *
   *
   *
   *
   *
   *
   *
 * * *
 * * *
 * * *
 * * *
 *****
 *****
 *****
 *****
 * * *
 * * *
 * * *
 * * *
 *****
 *****
 *****
 *****
 *****
 *****
 *****
 *****
 * * *
 * * *
 * * *
 * * *
 * * *
 * * *
 * * *
 * * *
 *****
 *****
 *****
 *****
 *****
 *****
 *****
 *****
 * * *
 * * *
 * * *
 * * *
 * * *
 * * *
 * * *
 * * *
   T
   T
   T
   T
   T
   T
  ***
  ***
  ***
  ***
  ***
  ***
 ** **
 ** **
 ** **
 ** **
**T*T**
**T*T**
**T*T**
**T*T**
 ** **
 ** **
 ** **
 ** **
**T*T**
**T*T**
**T*T**
**T*T**
 ** **
 ** **
 ** **
 ** **
W** **W
W** **W
W** **W
W** **W
W** **W
W** **W
W** **W
W** **W
*** ***
*** ***
*** ***
*** ***
*** ***
*** ***
*** ***
*** ***
* * * *
* * * *
* * * *
* * * *
* * * *
* * * *
* * * *
* * * *
 *****
 *****
 *****
 *****
* *** *
* *** *
* *** *
* *** *
* *** *
* *** *
* *** *
* *** *
W*****W
W*****W
W*****W
W*****W
* *** *
* *** *
* *** *
* *** *
* *** *
* *** *
* *** *
W*****W
W*****W
W*****W
W*****W
*******
*******